It was one of those days at the office, boring and intense at the same time. Your eyes are sore and the natural light feels weird after spending a day in a lamp-lit environment.

Red traffic light rushes you as you speed up to cross the two lanes that go from the cathedral passage to a small garden. After you crossed the street, you stop and look around. What would you like to think about?

think about

>x church
The ruins of the church clearly underwent restoration, making it seem that its demise was natural.

>x church
The ruins of the church clearly underwent restoration, making it seem that its demise was natural.

>look
Bronhood Square
You are by a garden, surrounded by comfy-looking benches. The vegetation starts to wither, but still provides a majestic centerpiece to the backdrop of an old, half-destroyed church.

Benches are already dry, even though you are pretty sure that it was raining this morning.

You can also see a church (empty) here.

>look at church
The ruins of the church clearly underwent restoration, making it seem that its demise was natural.

>x Greyfairs Church
You can't see any such thing.

>look west
You see nothing unexpected in that direction.

>w
Bronhood Church
You carefully enter a seventeenth century church through a heavy door of organic glass and dark plastic.

>e
Bronhood Square
You are by a garden, surrounded by comfy-looking benches. The vegetation starts to wither, but still provides a majestic centerpiece to the backdrop of an old, half-destroyed church.

Benches are already dry, even though you are pretty sure that it was raining this morning.

You can also see a church (empty) here.

>look at church
The ruins of the church clearly underwent restoration, making it seem that its demise was natural.

* * *

It was one of those days at the office, boring and intense at the same time. Your eyes are sore and the natural light feels weird after spending a day in a lamp-lit environment.

Red traffic light rushes you as you speed up to cross the two lanes that go from the cathedral passage to a small garden. After you crossed the street, you stop and look around. What would you like to think about?

think about

>exits
That's not a verb I recognise.

>l
Bronhood Square
You are by a garden, surrounded by comfy-looking benches. The vegetation starts to wither, but still provides a majestic centerpiece to the backdrop of an old, half-destroyed church. The ruins of the church clearly underwent restoration, making it seem that its demise was natural.

Benches are already dry, even though you are pretty sure that it was raining this morning.

>get bench
That's fixed in place.

* * *

It was one of those days at the office, boring and intense at the same time. Your eyes are sore and the natural light feels weird after spending a day in a lamp-lit environment.

Red traffic light rushes you as you speed up to cross the two lanes that go from the cathedral passage to a small garden. After you crossed the street, you stop and look around. What would you like to think about?

think about

>x bench
It would be nice to sit here and enjoy fresh air for a bit... Given how stressful the day at work was.

>think
What a good idea.

>think about
I only understood you as far as wanting to think.

>think about bench
I only understood you as far as wanting to think.

>l
Bronhood Garden
You are by a garden, surrounded by comfy-looking benches. The vegetation starts to wither, but still provides a majestic centerpiece to the backdrop of an old, half-destroyed church to the west. The ruins clearly underwent restoration, making it seem that its demise was natural.

Benches are already dry, even though you are pretty sure that it was raining this morning.

>n
Passage by the Hospital
The path from the peaceful square to the south brings you to a more chaotic place. Path to the Paul's Square paved with polished rusty-grey tiles bends northwest.

All kinds of people fill the grounds by the entrance to the hospital.

>x crowd
The facial expressions of the people you can make out show a broad spectrum of emotions. There are black lines on this spectrogram though: joy and happiness.

>x people
The facial expressions of the people you can make out show a broad spectrum of emotions. There are black lines on this spectrogram though: joy and happiness.

>s
Bronhood Garden
You are by a garden, surrounded by comfy-looking benches. The vegetation starts to wither, but still provides a majestic centerpiece to the backdrop of an old, half-destroyed church to the west. The ruins clearly underwent restoration, making it seem that its demise was natural.

Benches are already dry, even though you are pretty sure that it was raining this morning.

>x Church
You see nothing unexpected in that direction.

>Church
Bronhood Church
You carefully enter a seventeenth century church through a heavy door of organic glass and dark plastic.

>out
But you aren't in anything at the moment.

>Garden
That's not a verb I recognise.

>l
Bronhood Church
You carefully enter a seventeenth century church through a heavy door of organic glass and dark plastic.

>e
Bronhood Garden
You are by a garden, surrounded by comfy-looking benches. The vegetation starts to wither, but still provides a majestic centerpiece to the backdrop of an old, half-destroyed church to the west. The ruins clearly underwent restoration, making it seem that its demise was natural.

Benches are already dry, even though you are pretty sure that it was raining this morning.

* * *

It was one of those days at the office, boring and intense at the same time. Your eyes are sore and the natural light feels weird after spending a day in a lamp-lit environment.

Red traffic light rushes you as you speed up to cross the two lanes that go from the cathedral passage to a small garden. After you crossed the street, you stop and look around. What would you like to think about?

think about

>in
Which do you mean, the west or the inside?

>inside
You can't go that way.

>out
But you aren't in anything at the moment.

>go north
Passage by the Hospital
The path from the peaceful square to the south brings you to a more chaotic place. Path to the Paul's Square paved with polished rusty-grey tiles bends northwest.

All kinds of people fill the grounds by the entrance to the hospital.

* * *

It was one of those days at the office, boring and intense at the same time. Your eyes are sore and the natural light feels weird after spending a day in a lamp-lit environment.

Red traffic light rushes you as you speed up to cross the two lanes that go from the cathedral passage to a small garden. After you crossed the street, you stop and look around. What would you like to think about?

think about

>w
Bronhood Church
You carefully enter a seventeenth century church through a heavy door of organic glass and dark plastic. Behind your back, lies the picturesque garden.

>out
Bronhood Garden
You are by a garden, surrounded by comfy-looking benches. The vegetation starts to wither, but still provides a majestic centerpiece to the backdrop of an old, half-destroyed church to the west. The ruins clearly underwent restoration, making it seem that its demise was natural.

Benches are already dry, even though you are pretty sure that it was raining this morning.

>outside
Which do you mean, the east or the outside?

>go out
Which do you mean, the east or the outside?

>back
Bronhood Garden
You are by a garden, surrounded by comfy-looking benches. The vegetation starts to wither, but still provides a majestic centerpiece to the backdrop of an old, half-destroyed church to the west. The ruins clearly underwent restoration, making it seem that its demise was natural.

Benches are already dry, even though you are pretty sure that it was raining this morning.

>back
You can't go that way.

* * *

>out
Bronhood Garden
You are by a garden, surrounded by comfy-looking benches. The vegetation starts to wither, but still provides a majestic centerpiece to the backdrop of an old, half-destroyed church to the west. The ruins clearly underwent restoration, making it seem that its demise was natural.

Benches are already dry, even though you are pretty sure that it was raining this morning.

>w
Bronhood Church
You carefully enter a seventeenth century church through a heavy door of organic glass and dark plastic. Behind your back, lies the picturesque garden.

I beg your pardon?

>exit
Bronhood Garden
You are by a garden, surrounded by comfy-looking benches. The vegetation starts to wither, but still provides a majestic centerpiece to the backdrop of an old, half-destroyed church to the west. The ruins clearly underwent restoration, making it seem that its demise was natural.

Benches are already dry, even though you are pretty sure that it was raining this morning.

>w
Bronhood Church
You carefully enter a seventeenth century church through a heavy door of organic glass and dark plastic. Behind your back, lies the picturesque garden.

>go out
Bronhood Garden
You are by a garden, surrounded by comfy-looking benches. The vegetation starts to wither, but still provides a majestic centerpiece to the backdrop of an old, half-destroyed church to the west. The ruins clearly underwent restoration, making it seem that its demise was natural.

Benches are already dry, even though you are pretty sure that it was raining this morning.

>clear
(the bench)
It is fixed in place.

>quit
Are you sure you want to quit?

* * *

>w
Bronhood Church
You carefully enter a seventeenth century church through a heavy door of organic glass and dark plastic. Behind your back, lies the picturesque garden.

>exit
Bronhood Garden
You are by a garden, surrounded by comfy-looking benches. The vegetation starts to wither, but still provides a majestic centerpiece to the backdrop of an old, half-destroyed church to the west. The ruins clearly underwent restoration, making it seem that its demise was natural.

Benches are already dry, even though you are pretty sure that it was raining this morning.

>exit church
I only understood you as far as wanting to exit.

>outside
Bronhood Garden
You are by a garden, surrounded by comfy-looking benches. The vegetation starts to wither, but still provides a majestic centerpiece to the backdrop of an old, half-destroyed church to the west. The ruins clearly underwent restoration, making it seem that its demise was natural.

Benches are already dry, even though you are pretty sure that it was raining this morning.

>w
Bronhood Church
You carefully enter a seventeenth century church through a heavy door of organic glass and dark plastic. Behind your back, to the east, lies the picturesque garden.

>out
But you aren't in anything at the moment.

* * *

>exit
Bronhood Garden
You are by a garden, surrounded by comfy-looking benches. The vegetation starts to wither, but still provides a majestic centerpiece to the backdrop of an old, half-destroyed church to the west. The ruins clearly underwent restoration, making it seem that its demise was natural.

Benches are already dry, even though you are pretty sure that it was raining this morning.

>l
Bronhood Church
You carefully enter a seventeenth century church through a heavy door of organic glass and dark plastic. Behind your back, lies the picturesque garden.

>backl
That's not a verb I recognise.

>back
That's not a verb I recognise.

>go back
You can't see any such thing.

* * *

It was one of those days at the office, boring and intense at the same time. Your eyes are sore and the natural light feels weird after spending a day in a lamp-lit environment.

Red traffic light rushes you as you speed up to cross the two lanes that go from the cathedral passage to a small garden. After you crossed the street, you stop and look around. What would you like to think about?

think about

>lamp
Gosh, are they bright and artificial... But it doesn't matter, we stare at the screens all day anyways.
Oh, it's green! Gotta cross the street!

107
An Interactive Fiction by Jonn and George
Release 1 / Serial number 210923 / Inform 7 build 6M62 (I6/v6.33 lib 6/12N) SD
That's not a verb I recognise.

* * *

I beg your pardon?

I beg your pardon?

>x
What do you want to examine?

I beg your pardon?

* * *

It was one of those days at the office, boring and intense at the same time. Your eyes are sore and the natural light feels weird after spending a day in a lamp-lit environment.

Red traffic light rushes you as you speed up to cross the two lanes that go from the cathedral passage to a small garden. After you crossed the street, you stop and look around. What would you like to think about?

think about

>lamps, a lot of them!
This topic doesn't seem as interesting as running across the street while the traffic light is still green.
107
An Interactive Fiction by Jonn and George
Release 1 / Serial number 210923 / Inform 7 build 6M62 (I6/v6.33 lib 6/12N) SD
You seem to want to talk to someone, but I can't see whom.

* * *

It was one of those days at the office, boring and intense at the same time. Your eyes are sore and the natural light feels weird after spending a day in a lamp-lit environment.

Red traffic light rushes you as you speed up to cross the two lanes that go from the cathedral passage to a small garden. After you crossed the street, you stop and look around. What would you like to think about?

think about

>lamps
Are these lamps bright and artificial... But it doesn't matter, we stare at the screens all day anyways.
You think about it, but can't quite focus as your thoughts drift 

107
An Interactive Fiction by Jonn and George
Release 1 / Serial number 210924 / Inform 7 build 6M62 (I6/v6.33 lib 6/12N) SD

Bronhood Garden
You are by a garden, surrounded by comfy-looking benches. The vegetation starts to wither, but still provides a majestic centerpiece to the backdrop of an old, half-destroyed church to the west. The ruins clearly underwent restoration, making it seem that its demise was natural.

Benches are already dry, even though you are pretty sure that it was raining this morning.

That's not a verb I recognise.

I beg your pardon?

>l
Bronhood Garden
You are by a garden, surrounded by comfy-looking benches. The vegetation starts to wither, but still provides a majestic centerpiece to the backdrop of an old, half-destroyed church to the west. The ruins clearly underwent restoration, making it seem that its demise was natural.

Benches are already dry, even though you are pretty sure that it was raining this morning.

I beg your pardon?

>x
(the bench)
It would be nice to sit here and enjoy fresh air for a bit... Given how stressful the day at work was.

>w
Bronhood Church
You carefully enter a seventeenth century church through a heavy door of organic glass and dark plastic. Behind your back, lies the picturesque garden.

* * *

>exit
Bronhood Garden
You are by a garden, surrounded by comfy-looking benches. The vegetation starts to wither, but still provides a majestic centerpiece to the backdrop of an old, half-destroyed church to the west. The ruins clearly underwent restoration, making it seem that its demise was natural.

Benches are already dry, even though you are pretty sure that it was raining this morning.

>n
Passage by the Hospital
The path from the peaceful square to the south brings you to a more chaotic place. Path to the Paul's Square paved with polished rusty-grey tiles bends northwest.

All kinds of people fill the grounds by the entrance to the hospital.

* * *

>lamps
That's not a verb I recognise.

>hello?
That's not a verb I recognise.

>h
That's not a verb I recognise.

>w
Bronhood Church
You carefully enter a seventeenth century church through a heavy door of organic glass and dark plastic. Behind your back, lies the picturesque garden.

>back
That's not a verb I recognise.

>out
Bronhood Garden
You are by a garden, surrounded by comfy-looking benches. The vegetation starts to wither, but still provides a majestic centerpiece to the backdrop of an old, half-destroyed church to the west. The ruins clearly underwent restoration, making it seem that its demise was natural.

Benches are already dry, even though you are pretty sure that it was raining this morning.

>hellpo
That's not a verb I recognise.

* * *

It was one of those days at the office, boring and intense at the same time. Your eyes are sore and the natural light feels weird after spending a day in a lamp-lit environment.

Red traffic light rushes you as you speed up to cross the two lanes that go from the cathedral passage to a small garden. After you crossed the street, you stop and look around. What would you like to think about?

think about

>s
This topic doesn't seem as interesting as running across the street while the traffic light is still green.
Boop beep107
An Interactive Fiction by Jonn and George
Release 1 / Serial number 210923 / Inform 7 build 6M62 (I6/v6.33 lib 6/12N) SD

You can't go that way.

* * *

It was one of those days at the office, boring and intense at the same time. Your eyes are sore and the natural light feels weird after spending a day in a lamp-lit environment.

Red traffic light rushes you as you speed up to cross the two lanes that go from the cathedral passage to a small garden. After you crossed the street, you stop and look around. What would you like to think about?

think about

>beer
This topic doesn't seem as interesting as running across the street while the traffic light is still green.

107
An Interactive Fiction by Jonn and George
Release 1 / Serial number 210923 / Inform 7 build 6M62 (I6/v6.33 lib 6/12N) SD

Bronhood Garden
You are by a garden, surrounded by comfy-looking benches. The vegetation starts to wither, but still provides a majestic centerpiece to the backdrop of an old, half-destroyed church to the west. The ruins clearly underwent restoration, making it seem that its demise was natural.

Benches are already dry, even though you are pretty sure that it was raining this morning.

That's not a verb I recognise.

* * *

It was one of those days at the office, boring and intense at the same time. Your eyes are sore and the natural light feels weird after spending a day in a lamp-lit environment.

Red traffic light rushes you as you speed up to cross the two lanes that go from the cathedral passage to a small garden. After you crossed the street, you stop and look around. What would you like to think about?

think about

>road
There was not much traffic. Where there was a lot of traffic is in the work E-Mail... Your thoughts gravitate

107
An Interactive Fiction by Jonn and George
Release 1 / Serial number 210924 / Inform 7 build 6M62 (I6/v6.33 lib 6/12N) SD

Bronhood Garden
You are by a garden, surrounded by comfy-looking benches. The vegetation starts to wither, but still provides a majestic centerpiece to the backdrop of an old, half-destroyed church to the west. The ruins clearly underwent restoration, making it seem that its demise was natural.

Benches are already dry, even though you are pretty sure that it was raining this morning.

That's not a verb I recognise.